/sports/sports_league_draft/picks./sports/sports_league_draft_pick/player	None
/people/person/employment_history./business/employment_tenure/title	M-1
/astronomy/celestial_object_category/objects	None
/base/localfood/food_producing_region/seasonal_availability./base/localfood/produce_availability/produce	1-1
/aviation/airline/hubs	None
/education/educational_institution/students_graduates./education/education/student	1-M
/law/court/judges./law/judicial_tenure/judge	None
/people/person/spouse_s./people/marriage/type_of_union	M-1
/sports/pro_athlete/teams./basketball/basketball_roster_position/position	None
/people/family_member/family	None
/location/symbol_of_administrative_division/official_symbol_of./location/location_symbol_relationship/administrative_division	1-1
/transportation/bridge/bridge_type	None
/user/szaijan/fantasy_football/player/nfl_team	1-1
/astronomy/celestial_object/category	1-1
/basketball/basketball_player/player_statistics./basketball/basketball_player_stats/team	1-1
/sports/sports_team/roster./ice_hockey/hockey_roster_position/position	M-1
/computer/programming_language_designer/languages_designed	None
/computer/operating_system_developer/operating_systems_developed	1-M
/music/performance_role/regular_performances./music/group_membership/role	M-M
/fictional_universe/fictional_job_title/fictional_characters_with_this_job./fictional_universe/fictional_employment_tenure/employee	1-1
/sports/sports_team/championships	1-1
/film/film/film_series	1-1
/organization/organization/place_founded	1-1
/base/petbreeds/city_with_dogs/top_breeds./base/petbreeds/dog_city_relationship/dog_breed	M-1
/government/legislative_session/members./government/government_position_held/district_represented	M-M
/award/award_winner/awards_won./award/award_honor/award	M-1
/education/educational_institution/subsidiary_or_constituent_schools	1-M
/fictional_universe/fictional_character/occupation	1-1
/fictional_universe/character_gender/characters_of_this_gender	1-1
/base/popstra/celebrity/breakup./base/popstra/breakup/participant	1-1
/music/group_member/vocal_range	M-1
/sports/sport/related_equipment	1-1
/architecture/structure/architectural_style	1-1
/biology/animal_breed/breed_of	1-1
/soccer/football_player/current_team./sports/sports_team_roster/team	1-1
/military/military_combatant/casualties./military/casualties/military_conflict	1-1
/people/person/spouse_s./people/marriage/location_of_ceremony	1-1
/metropolitan_transit/transit_service_type/transit_lines	None
/film/film_featured_song/performed_by	None
/base/argumentmaps/morally_disputed_activity/instance_of_abstract_moral_dispute	1-1
/geography/geographical_feature/category	None
/education/field_of_study/students_majoring./education/education/institution	1-M
/organization/organization/leadership./organization/leadership/role	M-1
/comic_books/comic_book_series/created_by	None
/baseball/baseball_team/current_roster./sports/sports_team_roster/position	M-1
/american_football/football_player/rushing./american_football/player_rushing_statistics/season	1-1
/location/country/administrative_divisions	1-M
/royalty/noble_title/noble_rank	None
/award/award_ceremony/awards_presented./award/award_honor/award	M-M
/interests/collection_category/parent_category	None
/base/bioventurist/science_or_technology_company/develops_treatments_for_disease	None
/dining/restaurant/cuisine	1-1
/dining/cuisine/ingredients	None
/film/film/film_casting_director	M-1
/military/military_conflict/commanders./military/military_command/military_commander	1-1
/user/tfmorris/default_domain/signatory/documents_signed	None
/organization/organization/acquired_by./business/acquisition/acquiring_company	1-1
/medicine/medical_specialty/diseases_treated	1-M
/base/eating/practicer_of_diet/diet	M-1
/film/film/estimated_budget./measurement_unit/dated_money_value/currency	M-1
/award/award/presented_by	None
/government/legislative_session/members./government/government_position_held/governmental_body	M-1
/tv/tv_actor/guest_roles./tv/tv_guest_role/special_performance_type	M-1
/government/governmental_jurisdiction/governing_officials./government/government_position_held/legislative_sessions	1-M
/sports/sports_team/roster./basketball/basketball_roster_position/position	M-1
/celebrities/celebrity/sexual_orientation./celebrities/sexual_orientation_phase/sexual_orientation	M-1
/american_football/football_player/passing./american_football/player_passing_statistics/team	1-1
/protected_sites/governing_body_of_protected_sites/protected_sites_governed	None
/education/educational_institution/students_graduates./education/education/major_field_of_study	M-1
/base/thoroughbredracing/thoroughbred_racehorse/color	1-1
/base/collectives/collective/members./base/collectives/collective_membership/member	None
/base/ecology/food_web_member/belongs_to_ecosystem_s	None
/sports/sports_team/roster./baseball/baseball_roster_position/position	M-1
/education/fraternity_sorority/founded_location	None
/government/government_office_or_title/office_holders./government/government_position_held/office_holder	1-1
/military/military_person/service./military/military_service/rank	1-1
/computer/software/compatible_oses./computer/software_compatibility/operating_system	None
/transportation/bridge_type/bridges_of_this_type	None
/award/award_nominee/award_nominations./award/award_nomination/award_nominee	M-M
/tv/tv_program/country_of_origin	M-1
/base/petbreeds/dog_coat_color/dog_breeds	None
/tv/tv_personality/tv_regular_appearances./tv/tv_regular_personal_appearance/appearance_type	M-1
/base/patronage/client/related_patron./base/patronage/patron_client_relationship/patron	None
/protected_sites/site_listing_category/listed_sites./protected_sites/natural_or_cultural_site_listing/listed_site	1-1
/tv/tv_producer_type/tv_producers_of_this_type./tv/tv_producer_term/program	1-M
/projects/project_participant/projects./projects/project_participation/role	1-1
/education/academic_institution/visiting_scholars_fellows_etc./education/academic_post/person	None
/music/musical_group/member./music/group_membership/member	1-1
/broadcast/broadcast/distributor	None
/people/appointer/appointment_made./people/appointment/appointee	None
/protected_sites/iucn_category/protected_areas	None
/business/asset/owners./business/asset_ownership/owner	1-1
/music/artist/supporting_artists	1-1
/film/producer/film	1-1
/tennis/tennis_tournament_champion/tennis_titles./tennis/tennis_tournament_championship/winner	None
/film/film_costumer_designer/costume_design_for_film	1-M
/fictional_universe/fictional_character/based_on	None
/geography/lake_type/lakes_of_this_type	None
/tv/tv_producer/tv_episodes_produced./tv/tv_producer_episode_credit/episode	1-1
/book/newspaper/headquarters./location/mailing_address/citytown	None
/aviation/airline_alliance/member_airlines	None
/medicine/drug_ingredient/more_specific_ingredient	None
/government/politician/government_positions_held./government/government_position_held/appointed_by	1-1
/language/human_language/region	1-1
/people/person/employment_history./business/employment_tenure/company	1-1
/broadcast/distributor/distributes	None
/soccer/football_team/current_roster./soccer/football_roster_position/position	M-1
/organization/organization_member/member_of./organization/organization_membership/organization	M-1
/location/statistical_region/rent50_3./measurement_unit/dated_money_value/currency	M-1
/american_football/football_player/receiving./american_football/player_receiving_statistics/season	1-1
/cvg/gameplay_mode/games_with_this_mode	1-1
/film/film/release_date_s./film/film_regional_release_date/film_release_distribution_medium	M-1
/sports/drafted_athlete/drafted./sports/sports_league_draft_pick/team	1-1
/people/profession/specializations	1-M
/base/popstra/business_location/customer./base/popstra/hangout/customer	1-1
/award/ranked_list/ranked_list_items./award/ranking/item	1-M
/food/dish/ingredients	None
/olympics/olympic_sport/athletes./olympics/olympic_athlete_affiliation/country	M-M
/award/award_nominated_work/award_nominations./award/award_nomination/award_nominee	1-1
/location/location/people_born_here	1-M
/base/schemastaging/organization_extra/phone_number./base/schemastaging/phone_open_times/time_zone	M-1
/aviation/airport/serves	None
/visual_art/art_period_movement/associated_artists	1-1
/olympics/olympic_athlete/medals_won./olympics/olympic_medal_honor/medalist	1-1
/award/award_winning_work/awards_won./award/award_honor/ceremony	M-1
/geography/island/body_of_water	1-1
/sports/sports_position/players./ice_hockey/hockey_roster_position/team	1-M
/business/board_member/organization_board_memberships./organization/organization_board_membership/organization	1-1
/film/film/starring./film/performance/actor	1-1
/film/film_character/portrayed_in_films./film/performance/actor	1-1
/travel/tourist_attraction/near_travel_destination	1-1
/broadcast/content/genre	1-1
/tv/non_character_role/tv_regular_personal_appearances./tv/tv_regular_personal_appearance/person	1-M
/location/country/currency_formerly_used	None
/olympics/olympic_participating_country/athletes./olympics/olympic_athlete_affiliation/athlete	1-1
/sports/sports_league/teams./sports/sports_league_participation/team	1-M
/location/statistical_region/places_exported_to./location/imports_and_exports/exported_to	1-1
/government/political_district/representatives./government/government_position_held/legislative_sessions	M-M
/travel/travel_destination/climate./travel/travel_destination_monthly_climate/month	M-M
/user/lindenb/default_domain/scientist/known_for	None
/organization/organization/leadership./organization/leadership/person	1-1
/education/field_of_study/subdisciplines	1-1
/government/legislative_session/members./government/government_position_held/basic_title	M-1
/medicine/drug_class/drugs	None
/exhibitions/exhibition_venue/exhibitions_at_this_venue./exhibitions/exhibition_run/sponsor	1-1
/computer/programming_language/language_paradigms	M-1
/fictional_universe/fictional_universe/characters	None
/transportation/bridge/locale	None
/olympics/olympic_sport/olympic_games_contested	M-M
/olympics/olympic_games/athletes./olympics/olympic_athlete_affiliation/athlete	1-M
/biology/organism/organism_type	1-1
/broadcast/content/broadcast	None
/cvg/computer_videogame/characters./cvg/game_performance/voice_actor	None
/military/military_conflict/casualties./military/casualties/combatant	1-1
/soccer/football_team/current_roster./sports/sports_team_roster/player	1-1
/tv/tv_program/genre	M-1
/internet/website/owner_new./internet/website_ownership/owner	1-1
/education/fraternity_sorority/colleges_and_universities	1-M
/metropolitan_transit/transit_line/service_type	None
/location/statistical_region/gdp_nominal_per_capita./measurement_unit/dated_money_value/currency	M-1
/tv/tv_writer/episodes_written	None
/media_common/adaptation/adapted_from	1-1
/sports/pro_athlete/teams./sports/sports_team_roster/team	1-1
/computer/operating_system/includes_os_versions	1-1
/fictional_universe/fictional_character/powers_or_abilities	1-1
/travel/travel_destination/how_to_get_here./travel/transportation/transport_operator	M-1
/base/nobelprizes/nobel_subject_area/nobel_awards./base/nobelprizes/nobel_honor/subject_area	1-1
/base/disaster2/tactic/attacks_of_this_form./base/disaster2/attack_process/attack_event	None
/base/academyawards/host_of_oscar_show/oscar_show_hosted	1-1
/computer/software_developer/software	None
/base/americancomedy/impersonated_celebrity/impersonated_by	M-1
/military/military_post/used_by_armed_forces./military/military_post_use/armed_force	None
/base/parody/parodied_subject/parodies	M-1
/ice_hockey/hockey_position/players	None
/visual_art/visual_art_form/artists	1-M
/government/government_office_category/officeholders./government/government_position_held/jurisdiction_of_office	1-M
/government/politician/government_positions_held./government/government_position_held/governmental_body	1-1
/tv/tv_series_episode/guest_personal_appearances./tv/tv_guest_personal_appearance/person	None
/royalty/noble_title/holders./royalty/noble_title_tenure/noble_person	None
/location/administrative_division/second_level_division_of	M-1
/education/educational_degree/people_with_this_degree./education/education/student	1-M
/tv/tv_program/program_creator	1-1
/base/x2010fifaworldcupsouthafrica/world_cup_participant/world_cup_team./base/x2010fifaworldcupsouthafrica/current_world_cup_squad/position	1-1
/biology/domesticated_animal/breeds	1-M
/base/x2010fifaworldcupsouthafrica/world_cup_squad/current_world_cup_squad./base/x2010fifaworldcupsouthafrica/current_world_cup_squad/current_club	1-1
/people/appointed_role/appointment./people/appointment/appointee	None
/award/award_presenting_organization/awards_presented	1-1
/government/government_office_category/officeholders./government/government_position_held/legislative_sessions	1-M
/olympics/olympic_games/athletes./olympics/olympic_athlete_affiliation/country	M-M
/business/employer/employees./business/employment_tenure/person	1-1
/martial_arts/martial_artist/martial_art	1-1
/government/politician/party./government/political_party_tenure/party	M-1
/book/newspaper/owner	None
/american_football/football_player/receiving./american_football/player_receiving_statistics/team	None
/olympics/olympic_participating_country/athletes./olympics/olympic_athlete_affiliation/olympics	M-1
/base/popstra/celebrity/friendship./base/popstra/friendship/participant	1-1
/government/governmental_body/jurisdiction	1-1
/tv/special_tv_performance_type/starring_performances./tv/regular_tv_appearance/series	1-M
/military/military_combatant/military_commanders./military/military_command/military_commander	1-1
/tv/tv_program_creator/programs_created	1-1
/soccer/football_position/players	1-M
/film/film_production_designer/films_production_designed	1-M
/film/film/film_set_decoration_by	M-1
/sports/pro_athlete/teams./soccer/football_roster_position/position	M-1
/basketball/basketball_player/team./basketball/basketball_roster_position/team	1-1
/user/alexbl/honorary_title/titled_person/honorary_title./user/alexbl/honorary_title/honorary_title_holding/honorary_title	M-1
/user/mt/default_domain/metabolite/associated_disorder	1-1
/tennis/tennis_player/matches_won./tennis/tennis_match/loser	1-1
/influence/influence_node/peers./influence/peer_relationship/peers	1-1
/olympics/olympic_participating_country/athletes./olympics/olympic_athlete_affiliation/sport	M-M
/medicine/disease/symptoms	M-1
/base/popstra/celebrity/religion./base/popstra/religion_choice/religion	M-1
/biology/organism/sex	None
/book/literary_series/author_s	None
/sports/sports_championship_event/champion	1-1
/architecture/museum/address./location/mailing_address/citytown	1-1
/film/film/runtime./film/film_cut/type_of_film_cut	M-1
/base/americancomedy/comedian/comedy_genres	None
/film/film/music	M-1
/medicine/disease/treatments	1-1
/ice_hockey/hockey_player/current_team./ice_hockey/hockey_roster_position/team	None
/location/location/street_address./location/mailing_address/citytown	None
/visual_art/visual_art_genre/artworks	None
/tv/tv_producer/programs_produced./tv/tv_producer_term/producer_type	M-1
/soccer/football_team/manager./soccer/football_team_management_tenure/manager	None
/tv/non_character_role/tv_regular_personal_appearances./tv/tv_regular_personal_appearance/program	1-M
/people/profession/specialization_of	1-1
/film/film/personal_appearances./film/personal_film_appearance/type_of_appearance	None
/music/performance_role/regular_performances./music/group_membership/member	1-M
/government/governmental_body/members./government/government_position_held/office_position_or_title	None
/sports/sports_team/roster./basketball/basketball_historical_roster_position/player	1-M
/base/biblioness/bibs_location/city	1-1
/award/award_category/winners./award/award_honor/honored_for	1-M
/music/genre/parent_genre	M-1
/base/popstra/celebrity/eats_at./base/popstra/restaurant_choice/restaurant	1-1
/american_football/football_team/current_roster./sports/sports_team_roster/player	None
/film/film_distributor/films_distributed./film/film_film_distributor_relationship/film	1-M
/fictional_universe/fictional_character/character_created_by	1-1
/book/magazine/genre	1-1
/base/fight/crime_type/includes_crimes	1-1
/film/film/distributors./film/film_film_distributor_relationship/film_distribution_medium	M-1
/base/thoroughbredracing/thoroughbred_racehorse/country	None
/geography/geographical_feature_category/features	1-1
/book/written_work/original_language	None
/user/tsegaran/computer/algorithm/family	None
/fictional_universe/fictional_character/children	None
/base/activism/organization/area_of_activism	None
/base/popstra/celebrity/shops_at./base/popstra/shopping_choice/company	1-1
/education/educational_institution/colors	M-1
/cvg/computer_videogame/developer	1-1
/aviation/aircraft_manufacturer/aircraft_models_made	None
/broadcast/content/language	None
/soccer/football_team/league./soccer/football_league_participation/league	M-1
/film/film/executive_produced_by	M-1
/organization/organization_sector/organizations_in_this_sector	1-1
/language/human_language/writing_system	M-1
/education/field_of_study/students_majoring./education/education/major_field_of_study	M-M
/base/x2010fifaworldcupsouthafrica/world_cup_participant/world_cup_team./base/x2010fifaworldcupsouthafrica/current_world_cup_squad/national_team	1-1
/fictional_universe/fictional_setting/fictional_characters_born_here	None
/award/award_winning_work/awards_won./award/award_honor/award_winner	1-1
/baseball/baseball_player/former_teams./sports/sports_team_roster/team	1-1
/film/actor/dubbing_performances./film/dubbing_performance/film	1-1
/base/locations/countries/continent	M-1
/royalty/royal_line/monarchs_from_this_line	1-1
/american_football/football_team/historical_roster./american_football/football_historical_roster_position/player	1-1
/biology/organism_classification/lower_classifications	None
/government/governmental_jurisdiction/government_bodies	1-1
/architecture/structure/architect	None
/people/person/nationality	M-1
/basketball/basketball_position/player_roster_position./basketball/basketball_roster_position/team	1-M
/base/popstra/company/shopping_choice./base/popstra/shopping_choice/shopper	1-1
/medicine/drug_ingredient/more_general_ingredient	None
/book/author/school_or_movement	M-1
/location/country/second_level_divisions	1-M
/visual_art/art_subject/artwork_on_the_subject	None
/base/popstra/celebrity/supporter./base/popstra/support/supported_organization	1-1
/base/americancomedy/celebrity_impressionist/celebrities_impersonated	1-M
/sports/sport/leagues	1-1
/travel/transport_terminus/travel_destinations_served./travel/transportation/transport_terminus	None
/location/statistical_region/religions./location/religion_percentage/religion	M-1
/base/schemastaging/tv_actor_extra/regular_dubbing_performances./base/schemastaging/tv_star_dubbing_performance/character	None
/base/fight/sports_official/sport	None
/american_football/football_player/current_team./american_football/football_roster_position/team	None
/ice_hockey/hockey_team/current_roster./sports/sports_team_roster/position	M-1
/sports/sports_position/players./basketball/basketball_roster_position/player	1-1
/user/alexander/philosophy/philosopher/interests	1-1
/computer/programming_language/parent_language	None
/sports/sports_championship_event/championship	M-1
/medicine/disease/prevention_factors	None
/base/popstra/company/product_endorser./base/popstra/paid_support/endorser	1-1
/religion/religion/places_of_worship	None
/travel/transport_operator/travel_destinations_served./travel/transportation/mode_of_transportation	None
/business/job_title/people_with_this_title./business/employment_tenure/company	1-M
/sports/sports_team/league./sports/sports_league_participation/league	M-1
/base/contractbridge/bridge_player/first_place_finish./base/contractbridge/bridge_tournament_standings/second_place	1-M
/basketball/basketball_position/player_roster_position./sports/sports_team_roster/player	1-1
/cvg/game_character/games./cvg/game_performance/voice_actor	None
/base/schemastaging/athlete_extra/salary./base/schemastaging/athlete_salary/team	1-1
/fictional_universe/character_powers/characters_with_this_ability	1-M
/religion/religious_text/religious_text_of	1-1
/business/consumer_company/brands./business/company_brand_relationship/brand	None
/base/popstra/celebrity/canoodled./base/popstra/canoodled/participant	1-1
/award/award_nominated_work/award_nominations./award/award_nomination/nominated_for	1-1
/common/webpage/category	None
/organization/organization/headquarters./location/mailing_address/state_province_region	M-1
/sports/sports_championship/events	None
/basketball/basketball_team/roster./sports/sports_team_roster/player	None
/base/x2010fifaworldcupsouthafrica/world_cup_squad/current_world_cup_squad./base/x2010fifaworldcupsouthafrica/current_world_cup_squad/position	M-1
/location/hud_foreclosure_area/estimated_number_foreclosures./measurement_unit/dated_integer/source	M-1
/exhibitions/exhibition_sponsor/exhibitions_sponsored./exhibitions/exhibition_run/venue	None
/time/time_zone/locations_in_this_time_zone	1-M
/government/legislative_session/members./government/government_position_held/office_holder	M-1
/base/schemastaging/tv_character_extra/regular_dubbing_performances./base/schemastaging/tv_star_dubbing_performance/language	None
/business/board_member/leader_of./organization/leadership/organization	1-1
/common/topic/subject_of	1-1
/baseball/baseball_team/current_roster./sports/sports_team_roster/player	None
/base/popstra/company/fashion_choice./base/popstra/fashion_choice/fashion_wearer	1-M
/location/hud_foreclosure_area/total_residential_addresses./measurement_unit/dated_integer/source	M-1
/projects/project_role/projects./projects/project_participation/participant	1-1
/film/film/starring./film/performance/special_performance_type	M-1
/travel/transport_terminus/travel_destinations_served./travel/transportation/mode_of_transportation	None
/american_football/football_player/current_team./american_football/football_roster_position/position	None
/film/film/costume_design_by	1-1
/base/popstra/celebrity/vacations_in./base/popstra/vacation_choice/location	1-1
/language/language_family/languages	1-M
/olympics/olympic_athlete/country./olympics/olympic_athlete_affiliation/sport	M-1
/computer/operating_system/parent_os	1-1
/film/film_character/portrayed_in_films./film/performance/special_performance_type	1-1
/royalty/noble_title/used_in./royalty/system_title_relationship/system	None
/base/locations/continents/countries_within	1-M
/sports/sports_team_owner/teams_owned	1-1
/education/educational_degree/people_with_this_degree./education/education/institution	1-M
/sports/pro_athlete/teams./american_football/football_roster_position/team	None
/film/person_or_entity_appearing_in_film/films./film/personal_film_appearance/film	1-1
/base/yalebase/secret_society_member/belonged_to./base/yalebase/secret_society_membership/society	1-1
/film/film_format/film_format	1-M
/sports/tournament_event_competitor/events_competed_in./sports/competitor_competition_relationship/country	1-1
/organization/role/governors./organization/organization_board_membership/organization	1-1
/people/person/gender	M-1
/tv/tv_program/subjects	1-1
/government/governmental_jurisdiction/governing_officials./government/government_position_held/office_holder	1-1
/base/fashionmodels/hair_color/fashion_models_with_this_hair_color	None
/award/long_list_nominee/long_list_nominations./award/long_list_nomination/award	None
/location/statistical_region/rent50_0./measurement_unit/dated_money_value/currency	M-1
/sports/sports_award_winner/awards./sports/sports_award/team	1-1
/base/endorsements/endorsee/newspaper_endorsements./base/endorsements/newspaper_endorsement/newspaper	None
/film/film/prequel	1-1
/location/country/form_of_government	M-1
/business/company_type/companies_of_this_type	1-M
/government/governmental_jurisdiction/governing_officials./government/government_position_held/basic_title	M-1
/biology/animal_breed/registered_with./biology/breed_registration/breed_group	None
/aviation/airport/airlines./aviation/airline_airport_presence/cities_served	1-M
/education/academic/research_areas	1-1
/religion/religion/deities	None
/olympics/olympic_games/medals_awarded./olympics/olympic_medal_honor/medal	M-1
/celebrities/sexual_orientation/celebrities./celebrities/sexual_orientation_phase/celebrity	1-M
/base/schemastaging/athlete_extra/salary./base/schemastaging/athlete_salary/currency	M-1
/medicine/risk_factor/diseases	1-M
/film/film/distributors./film/film_film_distributor_relationship/region	M-1
/aviation/aircraft_model/number_owned_by./aviation/aircraft_ownership_count/aircraft_owner	1-1
/music/instrument/instrumentalists	1-M
/olympics/olympic_games/medals_awarded./olympics/olympic_medal_honor/country	M-M
/sports/pro_athlete/teams./american_football/football_historical_roster_position/team	1-1
/film/film_art_director/films_art_directed	1-1
/olympics/olympic_athlete/medals_won./olympics/olympic_medal_honor/olympics	M-1
/education/school_district/locations_served	None
/base/petbreeds/dog_breed/group	None
/organization/organization/founders	1-1
/location/location/partially_containedby	1-1
/baseball/baseball_player/lifetime_batting_statistics./baseball/lifetime_batting_statistics/starting_season	None
/award/award_category/long_lists./award/long_list_nomination/nominee	1-M
/interests/collection_category/sub_categories	1-1
/people/cause_of_death/parent_cause_of_death	1-1
/basketball/basketball_team/roster./sports/sports_team_roster/position	M-1
/base/crime/convicted_criminal/convictions./base/crime/criminal_conviction/guilty_of	1-1
/sports/sport_country/athletic_performances./sports/competitor_competition_relationship/competitors	None
/sports/sports_award_winner/awards./sports/sports_award/award	1-1
/people/person/children	1-1
/award/award_winner/awards_won./award/award_honor/honored_for	1-1
/government/politician/government_positions_held./government/government_position_held/office_position_or_title	1-1
/film/film/story_by	1-1
/film/film/country	M-1
/periodicals/newspaper_circulation_area/newspapers	None
/music/group_member/artists_supported	1-1
/base/famouspets/pet_owner/pets_owned./base/famouspets/pet_ownership/owner	None
/ice_hockey/hockey_player/hockey_position	None
/people/appointee/position./people/appointment/appointed_by	1-1
/award/award_category/nominees./award/award_nomination/nominated_for	M-M
/travel/travel_destination/how_to_get_here./travel/transportation/transport_terminus	1-1
/location/hud_county_place/place	1-1
/tv/tv_writer/tv_programs./tv/tv_program_writer_relationship/tv_program	1-1
/american_football/football_team/current_roster./sports/sports_team_roster/position	M-M
/film/film_festival_event/festival	1-1
/sports/sport/officials	None
/location/statistical_region/rent50_2./measurement_unit/dated_money_value/currency	M-1
/base/popstra/celebrity/hangout./base/popstra/hangout/business_location	1-1
/business/board_member/leader_of./organization/leadership/role	1-1
/people/person/education./education/education/major_field_of_study	1-1
/people/person/education./education/education/degree	M-1
/people/deceased_person/place_of_cremation	1-1
/broadcast/producer/produces	None
/film/film_job/films_with_this_crew_job./film/film_crew_gig/film	1-M
/film/film_crewmember/films_crewed./film/film_crew_gig/film_crew_role	M-1
/user/ktrueman/default_domain/international_organization/member_states	1-M
/music/performance_role/regular_performances./music/group_membership/group	1-M
/education/university/international_tuition./measurement_unit/dated_money_value/currency	M-1
/media_common/netflix_genre/titles	1-M
/film/film_festival/individual_festivals	1-1
/book/periodical_subject/periodicals	None
/military/military_commander/military_commands./military/military_command/military_combatant	1-1
/people/appointee/position./people/appointment/appointed_role	None
/olympics/olympic_games/athletes./olympics/olympic_athlete_affiliation/sport	M-M
/education/school_category/schools_of_this_kind	1-M
/business/business_operation/industry	M-1
/tv/tv_actor/starring_roles./tv/regular_tv_appearance/character	1-1
/education/educational_institution/parent_institution	1-1
/education/educational_institution_campus/educational_institution	1-1
/base/popstra/product/sold_to./base/popstra/product_choice/consumer	1-1
/location/statistical_region/places_imported_from./location/imports_and_exports/imported_from	1-1
/base/contractbridge/bridge_player/second_place_finish./base/contractbridge/bridge_tournament_standings/tournament	None
/architecture/building/building_function	None
/film/film/film_production_design_by	1-1
/exhibitions/exhibition_sponsor/exhibitions_sponsored./exhibitions/exhibition_run/sponsor	None
/music/album/artist	None
/medicine/disease/causes	1-1
/chemistry/chemical_compound/solubility./chemistry/solubility_relationship/solvent	1-1
/film/film/distributors./film/film_film_distributor_relationship/distributor	M-1
/architecture/architectural_style/examples	1-M
/film/director/film	1-1
/travel/transport_operator/travel_destinations_served./travel/transportation/travel_destination	1-M
/medicine/symptom/side_effect_of	None
/biology/breed_group/breeds_in_this_group./biology/breed_registration/breed	None
/olympics/olympic_games/participating_countries	1-M
/broadcast/radio_station/owner	None
/base/saturdaynightlive/snl_cast_member/seasons./base/saturdaynightlive/snl_season_tenure/cast_members	1-1
/medicine/disease/notable_people_with_this_condition	1-M
/language/language_writing_system/languages	1-M
/fictional_universe/fictional_setting/works_set_here	1-1
/organization/organization/legal_structure	M-1
/film/actor/film./film/performance/film	1-1
/people/person/religion	M-1
/baseball/baseball_player/former_teams./baseball/baseball_historical_roster_position/team	1-1
/tv/tv_actor/guest_roles./tv/tv_guest_role/character	1-1
/tv/tv_location/tv_shows_filmed_here	None
/film/film_character/portrayed_in_films_dubbed./film/dubbing_performance/language	None
/law/invention/inventor	None
/sports/pro_athlete/teams./basketball/basketball_historical_roster_position/team	1-1
/law/judge/courts./law/judicial_tenure/court	None
/government/political_district/representatives./government/government_position_held/jurisdiction_of_office	M-1
/sports/sports_team/roster./soccer/football_roster_position/position	M-1
/tv/tv_program/recurring_writers./tv/tv_program_writer_relationship/writer	1-1
/film/music_contributor/film	1-M
/tv/tv_program/spun_off_from	1-1
/people/ethnicity/includes_groups	1-1
/film/film_character/portrayed_in_films./film/performance/film	1-M
/base/activism/activism_issue/activists	1-1
/people/cause_of_death/includes_causes_of_death	1-1
/basketball/basketball_team/historical_roster./basketball/basketball_historical_roster_position/player	M-1
/royalty/system_of_nobility/titles./royalty/system_title_relationship/title	None
/film/film_distribution_medium/films_distributed_in_this_medium./film/film_film_distributor_relationship/film	1-M
/location/statistical_region/rent50_1./measurement_unit/dated_money_value/currency	M-1
/business/consumer_company/products./business/company_product_relationship/consumer_product	None
/sports/sports_facility/teams	None
/music/group_member/instruments_played	M-1
/sports/multi_event_tournament/sports	None
/olympics/olympic_games/sports	M-M
/time/event/locations	1-1
/film/film/production_companies	M-1
/visual_art/artwork/art_genre	None
/basketball/basketball_position/players	1-M
/base/crime/crime_victim/crime	1-1
/location/country/capital	1-1
/location/hud_county_place/county	1-1
/film/film_job/films_with_this_crew_job./film/film_crew_gig/crewmember	1-M
/education/field_of_study/academics_in_this_field	1-1
/education/educational_degree/people_with_this_degree./education/education/major_field_of_study	1-M
/film/special_film_performance_type/film_performance_type./film/performance/actor	1-M
/location/country/first_level_divisions	1-M
/film/editor/film	1-M
/education/academic/appointments_fellowships_etc./education/academic_post/institution	None
/business/business_operation/revenue./measurement_unit/dated_money_value/currency	M-1
/base/americancomedy/comedy_genre/comedians_in_this_genre	None
/organization/organization/geographic_scope	1-1
/tv/special_tv_performance_type/starring_performances./tv/regular_tv_appearance/actor	1-M
/medicine/medical_treatment/side_effects	None
/baseball/baseball_team/historical_roster./sports/sports_team_roster/player	1-1
/biology/organism_classification/organisms_of_this_type	1-1
/film/film/subjects	M-1
/film/film/dubbing_performances./film/dubbing_performance/actor	1-1
/travel/transport_operator/travel_destinations_served./travel/transportation/transport_operator	1-1
/sports/sports_team/colors	M-1
/location/country/official_language	M-1
/spaceflight/space_agency/astronauts	None
/travel/travel_destination/tourist_attractions	1-M
/baseball/baseball_player/current_team./baseball/baseball_roster_position/team	None
/award/award_discipline/awards_in_this_discipline	1-M
/cvg/computer_videogame/sequel	None
/business/job_title/people_with_this_title./business/employment_tenure/person	1-M
/book/periodical_format/periodicals_in_this_format./book/periodical_format_period/periodical	None
/base/aareas/schema/administrative_area/administrative_parent	M-1
/base/schemastaging/organization_extra/phone_number./base/schemastaging/phone_sandbox/service_language	M-1
/government/governmental_jurisdiction/official_symbols./location/location_symbol_relationship/symbol	1-1
/royalty/kingdom/rulers	1-1
/american_football/football_player/former_teams./sports/sports_team_roster/position	None
/film/film/featured_film_locations	M-1
/government/legislative_session/members./government/government_position_held/office_position_or_title	M-1
/olympics/olympic_athlete/medals_won./olympics/olympic_medal_honor/medal	M-1
/organization/organization/involved_in_merger./organization/organization_merger/organizations_merging	1-1
/computer/software/software_genre	M-1
/location/statistical_region/rent50_4./measurement_unit/dated_money_value/currency	M-1
/government/legislative_session/members./government/government_position_held/legislative_sessions	M-M
/award/award_nominated_work/award_nominations./award/award_nomination/award	M-M
/sports/sports_position/players./american_football/football_historical_roster_position/position_s	1-1
/book/periodical_publisher/periodicals_published./book/periodical_publisher_period/periodical	None
/media_common/media_genre/parent_genre	1-1
/base/contractbridge/bridge_player/second_place_finish./base/contractbridge/bridge_tournament_standings/second_place	1-1
/tv/tv_series_episode/series	M-1
/education/field_of_study/students_majoring./education/education/degree	M-1
/base/twinnedtowns/twinned_town/twinned_with./base/twinnedtowns/town_twinning/twinned_towns	None
/business/business_operation/retained_earnings./measurement_unit/dated_money_value/currency	M-1
/tv/tv_series_season/regular_cast./tv/regular_tv_appearance/actor	1-1
/film/film/release_date_s./film/film_regional_release_date/film_regional_debut_venue	M-1
/base/schemastaging/organization_extra/phone_number./base/schemastaging/phone_sandbox/contact_category	M-1
/sports/professional_sports_team/draft_picks./sports/sports_league_draft_pick/player	1-1
/user/tsegaran/random/subject_taxonomy/entry./user/tsegaran/random/taxonomy_entry/subject	1-M
/base/schemastaging/tv_character_extra/regular_dubbing_performances./base/schemastaging/tv_star_dubbing_performance/actor	None
/education/school_district/schools	None
/olympics/olympic_medal/medal_winners./olympics/olympic_medal_honor/olympics	1-M
/military/rank/used_by_services./military/military_service/military_person	1-1
/baseball/baseball_player/current_team./baseball/baseball_roster_position/position	None
/base/collectives/collective_member/member_of./base/collectives/collective_membership/collective	None
/tv/special_tv_performance_type/episode_performances./tv/tv_guest_role/actor	1-1
/common/topic/webpage./common/webpage/category	M-1
/common/topic/webpage./common/webpage/topic	1-1
/film/film/gross_revenue./measurement_unit/dated_money_value/currency	M-1
/user/robert/us_congress/house_committee/current_members	None
/music/artist/label	M-1
/base/eating/diets/people_who_follow_this_diet	1-M
/book/written_work/author	None
/media_common/netflix_title/netflix_genres	M-1
/book/author/works_written	1-1
/music/group_member/membership./music/group_membership/group	1-1
/location/hud_foreclosure_area/hhuniv./measurement_unit/dated_integer/source	M-1
/base/schemastaging/tv_program_extra/regular_dubbing_performances./base/schemastaging/tv_star_dubbing_performance/character	None
/government/legislative_session/legislature	M-1
/military/military_person/participated_in_conflicts	M-1
/government/government_office_or_title/category	None
/geography/lake/cities	1-M
/sports/sports_equipment/sport_used_for	None
/base/biblioness/bibs_location/country	M-1
/sports/sports_team/roster./basketball/basketball_roster_position/player	1-1
/organization/role/leaders./organization/leadership/person	1-M
/sports/sports_team/roster./american_football/football_historical_roster_position/player	1-1
/film/film/produced_by	1-1
/business/business_operation/assets./measurement_unit/dated_money_value/currency	M-1
/base/petbreeds/dog_breed/size./base/petbreeds/dog_size/gender	None
/sports/sports_position/players./american_football/football_historical_roster_position/team	M-M
/fictional_universe/fictional_character/appears_in_these_fictional_universes	M-1
/government/governmental_jurisdiction/governing_officials./government/government_position_held/appointed_by	1-1
/tv/tv_series_season/regular_cast./tv/regular_tv_appearance/seasons	1-1
/royalty/order_of_chivalry/recipients./royalty/chivalric_order_membership/recipient	1-1
/transportation/road/end2./transportation/road_starting_point/location	None
/tv/tv_character/appeared_in_tv_program./tv/regular_tv_appearance/actor	1-M
/film/special_film_performance_type/film_performance_type./film/performance/character	1-1
/computer/computer/manufacturer	None
/military/military_conflict/force_strengths./military/force_strength/combatant	1-M
/media_common/adapted_work/adaptations	1-1
/theater/theater_genre/plays_in_this_genre	None
/base/newsevents/news_reporting_organisation/news_reports./base/newsevents/news_report/event	1-1
/sports/professional_sports_team/draft_picks./sports/sports_league_draft_pick/school	1-M
/location/us_county/county_seat	1-1
/government/governmental_body/component_bodies	None
/award/award/category	1-M
/american_football/football_team/historical_roster./american_football/football_historical_roster_position/position_s	M-1
/architecture/museum/address./location/mailing_address/state_province_region	M-1
/food/food/nutrients./food/nutrition_fact/nutrient	M-M
/music/performance_role/guest_performances./music/recording_contribution/performance_role	M-M
/sports/sports_team/arena_stadium	None
/american_football/football_position/players	1-1
/religion/religion/notable_figures	1-1
/biology/breed_registry/recognized_breeds./biology/breed_registration/breed	None
/base/popstra/celebrity/dated./base/popstra/dated/participant	1-1
/american_football/football_player/former_teams./sports/sports_team_roster/team	1-1
/government/governmental_body/members./government/government_position_held/basic_title	M-1
/architecture/architectural_style/architects	None
/film/personal_film_appearance_type/film_appearances./film/personal_film_appearance/person	1-M
/sports/sports_position/players./american_football/football_roster_position/team	M-M
/media_common/dedicatee/dedications./media_common/dedication/work_dedicated	None
/film/film_festival_event/films	1-M
/music/genre/artists	1-M
/award/award_winning_work/awards_won./award/award_honor/honored_for	M-M
/soccer/football_player/matches_played./soccer/football_player_match_participation/team	1-1
/sports/sports_team/season_record./sports/sports_team_season_record/season	M-1
/base/contractbridge/bridge_player/first_place_finish./base/contractbridge/bridge_tournament_standings/tournament	1-1
/broadcast/genre/content	1-1
/visual_art/visual_artist/associated_periods_or_movements	1-1
/base/aareas/schema/administrative_area/administrative_children	1-M
/people/family/country	1-1
/tv/tv_program/languages	M-1
/cvg/computer_videogame/gameplay_modes	1-1
/martial_arts/martial_art/well_known_practitioner	None
/education/university/domestic_tuition./measurement_unit/dated_money_value/currency	M-1
/base/rugby/rugby_player/type_of_rugby	None
/award/award_winner/awards_won./award/award_honor/award_winner	M-M
/base/bioventurist/bv_medical_condition/company_involved	M-1
/computer/computer/compatible_oses./computer/os_compatibility/operating_system	None
/medicine/drug_ingredient/active_moiety_of_drug	None
/music/genre/albums	1-1
/location/location/adjoin_s./location/adjoining_relationship/adjoins	1-1
/theater/play/country_of_origin	None
/people/person/sibling_s./people/sibling_relationship/sibling	1-1
/olympics/olympic_athlete/medals_won./olympics/olympic_medal_honor/country	M-1
/soccer/football_player/goals_scored./soccer/football_goal/point_awarded_to	None
/business/business_operation/liabilities./measurement_unit/dated_money_value/currency	M-1
/baseball/baseball_player/current_team./sports/sports_team_roster/team	None
/base/marchmadness/ncaa_basketball_team/ncaa_tournament_seeds./base/marchmadness/ncaa_tournament_seed/tournament	M-M
/people/ethnicity/people	1-M
/education/academic/advisors	None
/base/culturalevent/event/entity_involved	1-1
/american_football/football_player/former_teams./american_football/football_historical_roster_position/team	1-1
/military/military_combatant/military_commanders./military/military_command/military_conflict	1-1
/government/government_office_category/officeholders./government/government_position_held/office_position_or_title	1-1
/baseball/baseball_league/teams	1-1
/organization/organization/spun_off_from./organization/organization_spin_off/parent_company	1-1
/comic_books/comic_book_fictional_universe/characters_primarily_appearing_in_this_universe	None
/biology/organism_classification/higher_classification	1-1
/business/business_operation/current_assets./measurement_unit/dated_money_value/currency	M-1
/olympics/olympic_medal/medal_winners./olympics/olympic_medal_honor/country	1-M
/royalty/monarch/kingdom	1-1
/location/administrative_division/capital./location/administrative_division_capital_relationship/capital	1-1
/film/film_festival/location	None
/government/political_appointer/appointees./government/government_position_held/office_holder	1-1
/film/actor/dubbing_performances./film/dubbing_performance/language	M-1
/book/book/genre	1-1
/tv/tv_program/regular_cast./tv/regular_tv_appearance/character	1-1
/location/administrative_division/first_level_division_of	1-1
/tennis/tennis_player/matches_lost./tennis/tennis_match/winner	1-1
/film/film/film_art_direction_by	M-1
/user/tfmorris/default_domain/document/signatories	1-1
/government/political_district/representatives./government/government_position_held/office_holder	1-1
/base/contractbridge/bridge_player/teammates./base/contractbridge/bridge_player_teammates/teammate	1-1
/business/asset_owner/assets_owned./business/asset_ownership/owned_asset	1-1
/tv/tv_actor/starring_roles./tv/regular_tv_appearance/special_performance_type	M-1
/military/rank/used_by_services./military/military_service/military_force	1-1
/government/political_ideology/political_parties	1-1
/base/aareas/schema/administrative_area/administrative_area_type	M-1
/basketball/basketball_position/player_roster_position./sports/sports_team_roster/team	1-M
/location/statistical_region/population./measurement_unit/dated_integer/source	None
/broadcast/broadcast/area_served	1-1
/government/government_office_or_title/governmental_body_if_any	None
/military/military_conflict/military_personnel_involved	1-M
/film/film_series/films_in_series	1-1
/education/university/local_tuition./measurement_unit/dated_money_value/currency	M-1
/film/personal_film_appearance_type/film_appearances./film/personal_film_appearance/film	1-1
/geography/river/basin_countries	1-1
/time/event/includes_event	1-1
/olympics/olympic_athlete/country./olympics/olympic_athlete_affiliation/olympics	M-1
/travel/transport_terminus/travel_destinations_served./travel/transportation/travel_destination	1-1
/theater/theater_character/portrayed_by./theater/theater_role/actor	None
/sports/sports_team_location/teams	1-1
/soccer/football_player/position_s	M-1
/sports/pro_athlete/teams./american_football/football_historical_roster_position/position_s	None
/medicine/icd_9_cm_classification/includes_classifications	None
/government/politician/government_positions_held./government/government_position_held/basic_title	M-1
/sports/sports_championship_event/runner_up	1-1
/cvg/cvg_publisher/games_published	None
/film/film/personal_appearances./film/personal_film_appearance/person	1-1
/location/it_province/capital	None
/food/dietary_restriction/incompatible_ingredients	1-1
/military/armed_force/personnel./military/military_service/military_person	1-M
/sports/sports_team/roster./sports/sports_team_roster/position	M-1
/american_football/football_team/current_roster./american_football/football_roster_position/position	M-M
/film/film/film_festivals	M-1
/award/recurring_competition/individual_competitions	None
/organization/organization/headquarters./location/mailing_address/country	M-1
/education/educational_institution/students_graduates./education/education/specialization	1-1
/tv/tv_series_episode/producers./tv/tv_producer_episode_credit/producer	None
/sports/sports_award_winner/awards./sports/sports_award/season	None
/government/government_office_category/officeholders./government/government_position_held/office_holder	1-M
/base/schemastaging/tv_actor_extra/regular_dubbing_performances./base/schemastaging/tv_star_dubbing_performance/language	M-1
/tv/tv_actor/starring_roles./tv/regular_tv_appearance/seasons	1-1
/location/country/languages_spoken	M-1
/base/popstra/celebrity/bought./base/popstra/product_choice/product	1-1
/astronomy/orbital_relationship/orbits	1-1
/base/americancomedy/comedy_group/members./base/americancomedy/comedy_group_membership/member	1-1
/fictional_universe/fictional_character/married_to./fictional_universe/marriage_of_fictional_characters/spouses	None
/music/musical_group/member./music/group_membership/role	M-M
/religion/religion/organizations	None
/geography/island_group/islands_in_group	1-1
/food/ingredient/incompatible_with_dietary_restrictions	M-1
/astronomy/orbital_relationship/orbited_by	1-M
/base/endorsements/endorsing_newspaper/endorsements./base/endorsements/newspaper_endorsement/election	None
/military/military_combatant/force_deployments./military/force_strength/combatant	1-1
/geography/lake/lake_type	None
/film/film/sequel	1-1
/american_football/football_player/games./american_football/player_game_statistics/season	1-1
/medicine/type_of_infectious_agent/diseases	None
/base/petbreeds/dog_breed/cities_where_this_dog_is_popular./base/petbreeds/dog_city_relationship/cities	1-M
/education/school/highest_grade_taught	1-1
/award/award_nominee/award_nominations./award/award_nomination/nominated_for	1-1
/food/ingredient/compatible_with_dietary_restrictions	M-1
/music/concert_tour/artist	None
/government/government_office_or_title/jurisdiction	1-1
/base/popstra/restaurant/restaurant_choice./base/popstra/restaurant_choice/diner	1-M
/organization/organization_founder/organizations_founded	1-1
/film/film/dubbing_performances./film/dubbing_performance/language	M-1
/base/popstra/organization/supporter./base/popstra/support/supporter	1-1
/film/actor/film./film/performance/special_performance_type	M-1
/tv/tv_personality/tv_regular_appearances./tv/tv_regular_personal_appearance/program	M-1
/education/field_of_study/subdiscipline_of	1-1
/education/educational_institution/students_graduates./education/education/degree	M-1
/award/award_winning_work/awards_won./award/award_honor/award	M-1
/dataworld/gardening_hint/split_to	1-1
/user/robert/us_congress/us_representative/committee_memberships	1-1
/fictional_universe/fictional_character/employers./fictional_universe/fictional_employment_tenure/title	None
/base/nobelprizes/nobel_prize_winner/nobel_honor./base/nobelprizes/nobel_honor/subject_area	M-1
/people/marriage_union_type/unions_of_this_type./people/marriage/location_of_ceremony	1-M
/american_football/football_team/historical_roster./sports/sports_team_roster/position	M-M
/aviation/airliner_accident/flight_destination	None
/government/governmental_body/sessions	1-M
/medicine/disease/includes_diseases	1-1
/basketball/basketball_player/team./basketball/basketball_roster_position/position	None
/government/governmental_body/members./government/government_position_held/jurisdiction_of_office	None
/baseball/baseball_team/league	1-1
/american_football/football_player/passing./american_football/player_passing_statistics/season	None
/book/newspaper/headquarters./location/mailing_address/state_province_region	None
/basketball/basketball_player/team./sports/sports_team_roster/position	1-1
/baseball/baseball_team/team_stats./baseball/baseball_team_stats/season	M-1
/sports/sports_position/players./ice_hockey/hockey_roster_position/player	None
/cvg/cvg_genre/games	None
/sports/sports_team/sport	M-1
/base/activism/activist/area_of_activism	M-1
/computer/programming_language/language_designers	None
/government/government_office_category/offices	1-1
/computer/computer_manufacturer_brand/computer_models	1-1
/basketball/basketball_player/former_teams./basketball/basketball_historical_roster_position/team	1-1
/ice_hockey/hockey_player/former_team_s./ice_hockey/hockey_previous_roster_position/team	None
/architecture/type_of_museum/museums	1-1
/common/resource/annotations./common/webpage/topic	None
/ice_hockey/hockey_team/current_roster./sports/sports_team_roster/player	1-1
/soccer/football_team_manager/team./soccer/football_team_management_tenure/team	1-1
/tv/tv_program/original_network./tv/tv_network_duration/network	M-1
/ice_hockey/hockey_team/current_roster./ice_hockey/hockey_roster_position/player	None
/broadcast/tv_station_owner/tv_stations	None
/award/award_category/disciplines_or_subjects	M-1
/soccer/football_team/current_roster./sports/sports_team_roster/position	M-1
/tv/special_tv_performance_type/starring_performances./tv/regular_tv_appearance/character	None
/aviation/airline/airports_served./aviation/airline_airport_presence/airport	1-1
/olympics/olympic_participating_country/medals_won./olympics/olympic_medal_honor/medal	M-1
/tv/tv_program/spin_offs	1-1
/location/capital_of_administrative_division/capital_of./location/administrative_division_capital_relationship/administrative_division	1-1
/basketball/basketball_team/roster./basketball/basketball_roster_position/player	1-M
/time/event/instance_of_recurring_event	M-1
/basketball/basketball_team/roster./basketball/basketball_roster_position/position	M-1
/base/schemastaging/person_extra/net_worth./measurement_unit/dated_money_value/currency	M-1
/ice_hockey/hockey_player/current_team./sports/sports_team_roster/position	None
/sports/sports_team/roster./baseball/baseball_roster_position/player	None
/comic_books/comic_book_series/featured_characters	None
/religion/deity/deity_of	1-M
/base/thoroughbredracing/thoroughbred_racehorse_sex/horses_of_this_sex	None
/fictional_universe/fictional_character/parents	None
/media_common/media_genre/child_genres	1-1
/user/alexander/philosophy/philosopher/era	1-1
/base/thoroughbredracing/thoroughbred_racehorse_color/horses_of_this_color	None
/location/us_county/hud_county_place	1-1
/film/film/other_crew./film/film_crew_gig/film_crew_role	M-1
/cvg/computer_videogame/game_series	None
/sports/pro_athlete/teams./soccer/football_roster_position/team	1-M
/architecture/building_function/buildings	1-1
/government/legislative_session/members./government/government_position_held/jurisdiction_of_office	M-1
/film/cinematographer/film	1-M
/baseball/baseball_player/batting_stats./baseball/batting_statistics/season	1-M
/sports/pro_athlete/sports_played_professionally./sports/pro_sports_played/sport	M-1
/theater/theatrical_lyricist/play_lyrics_written	None
/religion/religion/is_part_of	1-1
/metropolitan_transit/transit_system/area_served	None
/film/film/cinematography	1-1
/fictional_universe/fictional_character/ethnicity	None
/user/alexbl/honorary_title/honorary_title/titled_people./user/alexbl/honorary_title/honorary_title_holding/conferred_upon	1-M
/award/award_category/winners./award/award_honor/ceremony	M-M
/organization/organization/companies_acquired./business/acquisition/company_acquired	1-1
/education/school_mascot/school	None
/finance/currency/countries_formerly_used	None
/book/newspaper/circulation_areas	1-1
/people/person/education./education/education/institution	M-1
/people/deceased_person/place_of_death	M-1
/film/film/edited_by	M-1
/dining/cuisine/dishes	None
/cvg/computer_videogame/subjects	1-1
/base/crime/crime_victim/crime_type	1-1
/cvg/computer_videogame/designers	None
/architecture/structure/owner./architecture/ownership/owner	None
/education/educational_institution/sports_teams	1-1
/comic_books/comic_book_publisher/comic_book_series_published	None
/fictional_universe/fictional_character/species	1-1
/music/performance_role/track_performances./music/track_contribution/contributor	1-M
/fictional_universe/character_rank/characters_of_this_rank	None
/medicine/medical_treatment/used_to_treat	1-1
/law/inventor/inventions	None
/music/conducted_ensemble/conductors./music/conducting_tenure/conductor	None
/broadcast/radio_station/format	None
/music/performance_role/track_performances./music/track_contribution/role	M-M
/base/schemastaging/organization_extra/phone_number./base/schemastaging/phone_sandbox/product_or_service	1-1
/base/x2010fifaworldcupsouthafrica/world_cup_squad/current_world_cup_squad./base/x2010fifaworldcupsouthafrica/current_world_cup_squad/players	1-1
/sports/sport/teams	1-M
/transportation/road/major_cities	1-M
/symbols/name_source/namesakes	1-1
/organization/role/leaders./organization/leadership/organization	1-M
/ice_hockey/hockey_player/former_team_s./sports/sports_team_roster/team	1-1
/film/film/dubbing_performances./film/dubbing_performance/character	None
/government/political_party/politicians_in_this_party./government/political_party_tenure/politician	1-M
/location/statistical_region/gni_in_ppp_dollars./measurement_unit/dated_money_value/currency	M-1
/base/contractbridge/bridge_tournament/standing./base/contractbridge/bridge_tournament_standings/first_place	None
/people/ethnicity/included_in_group	1-1
/fictional_universe/fictional_character/siblings./fictional_universe/sibling_relationship_of_fictional_characters/siblings	None
/education/academic/advisees	None
/baseball/baseball_player/lifetime_batting_statistics./baseball/lifetime_batting_statistics/ending_season	1-1
/religion/religious_practice/practice_of	1-1
/common/webpage/topic	None
/film/film_subject/films	1-M
/sports/sports_team/location	1-1
/tv/tv_program/regular_personal_appearances./tv/tv_regular_personal_appearance/person	1-1
/location/location/contains	1-M
/medicine/disease/risk_factors	M-1
/business/sponsor/sponsorship./business/sponsorship/sponsored_recipient	None
/geography/body_of_water/islands	1-1
/government/politician/government_positions_held./government/government_position_held/jurisdiction_of_office	M-1
/tv/tv_actor/starring_roles./tv/regular_tv_appearance/series	1-1
/architecture/architect/architectural_style	1-1
/architecture/structure/address./location/mailing_address/citytown	1-1
/organization/organization/parent./organization/organization_relationship/parent	1-1
/base/fight/sentence/convictions./base/crime/criminal_conviction/convicted_person	None
/government/governmental_body/members./government/government_position_held/district_represented	1-M
/sports/sports_team/roster./baseball/baseball_historical_roster_position/player	1-1
/user/tsegaran/computer/algorithm_family/algorithm	None
/sports/sports_team/roster./american_football/football_historical_roster_position/position_s	M-M
/music/performance_role/guest_performances./music/recording_contribution/contributor	1-M
/book/school_or_movement/associated_authors	1-1
/aviation/aircraft_owner/aircraft_fleet_composition./aviation/aircraft_ownership_count/aircraft_model	None
/sports/drafted_athlete/drafted./sports/sports_league_draft_pick/school	1-1
/base/schemastaging/organization_extra/phone_number./base/schemastaging/phone_sandbox/service_location	M-1
/government/governmental_jurisdiction/governing_officials./government/government_position_held/office_position_or_title	1-1
/sports/pro_athlete/teams./basketball/basketball_roster_position/team	None
/book/book_subject/works	None
/film/film/other_crew./film/film_crew_gig/crewmember	M-1
/education/educational_institution/sexes_accepted./education/gender_enrollment/sex	M-1
/base/saints/saint/venerated_in	1-1
/fictional_universe/fictional_character/rank	None
/sports/sports_position/players./soccer/football_roster_position/team	1-M
/religion/religion/includes	1-1
/base/wrestling/solo_wrestler_or_team/members	None
/sports/pro_athlete/teams./ice_hockey/hockey_roster_position/team	None
/base/fashionmodels/fashion_model/hair_color	None
/tv/tv_producer_type/tv_producers_of_this_type./tv/tv_producer_term/producer	1-M
/education/educational_institution/school_type	M-1
/base/argumentmaps/original_idea/innovator	None
/symbols/namesake/named_after	1-1
/biology/animal_breed/registered_with./biology/breed_registration/registry	None
/aviation/airport/focus_city_for	1-1
/sports/sport/pro_athletes./sports/pro_sports_played/athlete	1-M
/film/film_set_designer/film_sets_designed	1-1
/aviation/airline/alliance	None
/computer/software/license	None
/user/szaijan/fantasy_football/position/player	None
/music/artist/track_contributions./music/track_contribution/role	M-1
/sports/professional_sports_team/owner_s	1-1
/theater/play/lyricist	None
/basketball/basketball_player/team./sports/sports_team_roster/team	1-1
/media_common/dedicated_work/dedication./media_common/dedication/dedicated_to	None
/medicine/infectious_disease/infectious_agent_type	None
/common/annotation_category/annotations./common/webpage/topic	1-M
/film/film_crewmember/films_crewed./film/film_crew_gig/film	1-M
/architecture/museum/type_of_museum	1-1
/cvg/game_character/games./cvg/game_performance/game	1-1
/business/consumer_product/company./business/company_product_relationship/company	None
/basketball/basketball_player/position_s	M-1
/food/dish/cuisine	None
/base/onephylogeny/type_of_thing/includes	None
/people/person/spouse_s./people/marriage/spouse	1-1
/education/university/fraternities_and_sororities	M-1
/government/governmental_body/members./government/government_position_held/office_holder	1-M
/government/political_appointer/appointees./government/government_position_held/basic_title	M-1
/fictional_universe/fictional_character_creator/fictional_characters_created	1-1
/comic_books/comic_book_character/created_by	1-1
/base/americancomedy/comedy_group_member/belongs_to./base/americancomedy/comedy_group_membership/group	M-1
/book/magazine_genre/magazines_in_this_genre	1-1
/film/film_character/portrayed_in_films_dubbed./film/dubbing_performance/film	1-1
/film/film/runtime./film/film_cut/film_release_region	M-1
/travel/travel_destination/local_transportation	1-1
/time/event/included_in_event	1-1
/film/production_company/films	1-M
/cvg/computer_videogame/publisher	None
/olympics/olympic_medal/medal_winners./olympics/olympic_medal_honor/medalist	1-M
/computer/operating_system/developer	None
/location/administrative_division/country	M-1
/government/government_office_category/officeholders./government/government_position_held/governmental_body	1-M
/education/field_of_study/students_majoring./education/education/minor	1-1
/tv/tv_program/seasons	None
/user/hangy/default_domain/sports_team_gender/gender	M-1
/architecture/architectural_structure_owner/structures_owned./architecture/ownership/structure	None
/sports/sports_position/players./sports/sports_team_roster/position	M-1
/location/location/partially_contains	1-1
/people/person/ethnicity	M-1
/base/x2010fifaworldcupsouthafrica/world_cup_participant/world_cup_team./base/x2010fifaworldcupsouthafrica/current_world_cup_squad/current_club	None
/games/game_genre/boardgames	None
/tv/tv_program/tv_producer./tv/tv_producer_term/producer_type	M-1
/base/schemastaging/tv_actor_extra/regular_dubbing_performances./base/schemastaging/tv_star_dubbing_performance/program	1-1
/base/parody/parody/parody_of	1-1
/government/government_office_or_title/office_holders./government/government_position_held/basic_title	1-1
/user/alexander/misc/murdered_person/place_murdered	1-1
/aviation/aircraft_model/aircraft_type	None
/film/film/film_format	M-1
/language/language_dialect/language	None
/military/military_combatant/military_conflicts./military/military_combatant_group/conflict	M-1
/internet/website_category/sites	M-1
/theater/theater_actor/theater_roles./theater/theater_role/role	1-1
/base/usnationalparks/us_national_park/state	None
/media_common/dedicator/dedications./media_common/dedication/dedicated_to	1-1
/film/actor/film./film/performance/character	M-1
/government/political_district/representatives./government/government_position_held/basic_title	1-1
/baseball/baseball_player/position_s	1-1
/media_common/dedicator/dedications./media_common/dedication/work_dedicated	None
/organization/organization/headquarters./location/mailing_address/citytown	1-1
/organization/non_profit_organization/registered_with./organization/non_profit_registration/registering_agency	M-1
/cvg/computer_game_subject/games	1-1
/location/location/events	1-1
/fictional_universe/person_in_fiction/representations_in_fiction	None
/sports/sports_league_draft/picks./sports/sports_league_draft_pick/team	1-M
/aviation/airport/hub_for	1-1
/education/school/school_district	None
/government/political_appointer/appointees./government/government_position_held/governmental_body	M-1
/olympics/olympic_participating_country/medals_won./olympics/olympic_medal_honor/olympics	M-M
/award/award_winner/awards_won./award/award_honor/ceremony	M-1
/award/award_category/category_of	M-1
/organization/organization/product_of_merger./organization/organization_merger/organizations_merging	1-1
/sports/sports_position/players./sports/sports_team_roster/player	1-M
/business/employer/employees./business/employment_tenure/title	M-1
/religion/religion/texts	None
/broadcast/tv_station/owner	None
/medicine/disease/medical_specialties	M-1
/location/country/currency_used	M-1
/religion/place_of_worship/religion	None
/base/contractbridge/bridge_player/second_place_finish./base/contractbridge/bridge_tournament_standings/first_place	1-1
/government/government_office_category/officeholders./government/government_position_held/appointed_by	1-M
/baseball/baseball_player/batting_stats./baseball/batting_statistics/team	1-1
/organization/organization/involved_in_merger./organization/organization_merger/became_organization	1-1
/baseball/baseball_team/current_roster./baseball/baseball_roster_position/position	M-1
/language/human_language/main_country	1-1
/base/popstra/celebrity/endorsements./base/popstra/paid_support/company	1-1
/location/statistical_region/gdp_real./measurement_unit/adjusted_money_value/adjustment_currency	M-1
/award/hall_of_fame/discipline	1-1
/biology/organism_classification_rank/organism_classifications	1-1
/protected_sites/listed_site/designation_as_natural_or_cultural_site./protected_sites/natural_or_cultural_site_listing/designation	M-1
/cvg/cvg_developer/games_developed	1-1
/people/place_of_interment/interred_here	1-M
/government/form_of_government/countries	1-M
/award/hall_of_fame_discipline/halls_of_fame	1-M
/soccer/football_team/current_roster./soccer/football_roster_position/player	1-1
/organization/organization/board_members./organization/organization_board_membership/member	1-1
/tv/tv_series_episode/guest_stars./tv/tv_guest_role/actor	1-1
/tv/tv_network/areas_served	M-1
/film/film/other_film_companies./film/film_film_company_relationship/film_company	M-1
/government/governmental_body/body_this_is_a_component_of	None
/government/political_district/representatives./government/government_position_held/governmental_body	M-1
/location/location/nearby_airports	1-1
/american_football/football_coach_position/coaches_holding_this_position./american_football/football_historical_coach_position/team	1-M
/award/hall_of_fame_induction_category/inductees./award/hall_of_fame_induction/inductee	None
/fictional_universe/work_of_fiction/setting	None
/medicine/drug/active_moieties	1-1
/fictional_universe/work_of_fiction/part_of_these_fictional_universes	1-1
/fictional_universe/fictional_universe/works_set_here	None
/base/folklore/mythology/mythical_creatures	None
/religion/religious_organization/leaders./religion/religious_organization_leadership/leader	None
/tv/tv_program_guest/appeared_on./tv/tv_guest_personal_appearance/appearance_type	M-1
/aviation/airline/focus_cities	1-M
/government/governmental_body/members./government/government_position_held/appointed_by	1-1
/protected_sites/listed_site/designation_as_natural_or_cultural_site./protected_sites/natural_or_cultural_site_listing/category_or_criteria	None
/education/fraternity_sorority/colors	None
/business/business_operation/cash./measurement_unit/dated_money_value/currency	M-1
/film/film_character/portrayed_in_films_dubbed./film/dubbing_performance/actor	None
/sports/sports_team/roster./soccer/football_roster_position/player	1-1
/education/school/lowest_grade_taught	1-1
/sports/pro_athlete/teams./sports/sports_team_roster/position	1-1
/government/political_party/ideology	1-1
/education/field_of_study/students_majoring./education/education/student	1-1
/aviation/aircraft_type/aircraft_of_this_type	None
/media_common/dedicated_work/dedication./media_common/dedication/dedicated_by	1-1
/military/military_combatant/military_conflicts./military/military_combatant_group/combatants	M-M
/base/thoroughbredracing/thoroughbred_racehorse/sex	1-1
/sports/pro_athlete/teams./baseball/baseball_historical_roster_position/team	1-1
/music/album/genre	1-1
/base/contractbridge/bridge_player/first_place_finish./base/contractbridge/bridge_tournament_standings/first_place	1-1
/tv/tv_program/regular_personal_appearances./tv/tv_regular_personal_appearance/appearance_type	1-1
/media_common/dedicatee/dedications./media_common/dedication/dedicated_by	1-1
/base/infrastructure/power_station/fuel_type	None
/sports/sports_league_draft/picks./sports/sports_league_draft_pick/school	1-M
/fictional_universe/character_species/characters_of_this_species	1-1
/comic_books/comic_book_character/primary_universe	1-1
/broadcast/radio_station_owner/radio_stations	None
/tv/non_character_role/tv_guest_personal_appearances./tv/tv_guest_personal_appearance/person	1-M
/military/military_conflict/commanders./military/military_command/military_combatant	1-1
/base/localfood/seasonal_month/produce_available./base/localfood/produce_availability/seasonal_months	1-1
/award/award_category/winners./award/award_honor/award_winner	1-M
/award/award_category/presenting_organization	M-1
/food/diet_follower/follows_diet	M-1
/medicine/disease_cause/diseases	1-1
/education/field_of_study/students_majoring./education/education/specialization	1-1
/people/deceased_person/place_of_burial	M-1
/architecture/structure/construction_cost./measurement_unit/money_value/currency	None
/american_football/football_team/historical_coaching_staff./american_football/football_historical_coach_position/coach	None
/base/localfood/produce/availability./base/localfood/produce_availability/location	1-1
/film/film/directed_by	1-1
/medicine/disease/parent_disease	M-1
/award/award_ceremony/awards_presented./award/award_honor/award_winner	1-M
/olympics/olympic_games/medals_awarded./olympics/olympic_medal_honor/medalist	1-1
/protected_sites/natural_or_cultural_site_designation/sites./protected_sites/natural_or_cultural_site_listing/listed_site	1-M
/american_football/football_coach_position/coaches_holding_this_position./american_football/football_historical_coach_position/coach	None
/user/alexander/philosophy/subject/philosophers	1-1
/aviation/airport/airlines./aviation/airline_airport_presence/airline	1-1
/people/appointer/appointment_made./people/appointment/appointed_role	1-1
/organization/membership_organization/members./organization/organization_membership/member	1-M
/location/location/containedby	M-1
/tv/tv_series_season/regular_cast./tv/regular_tv_appearance/series	None
/food/diet/followers	1-M
/location/statistical_region/gni_per_capita_in_ppp_dollars./measurement_unit/dated_money_value/currency	M-1
/royalty/chivalric_order_member/belongs_to_order./royalty/chivalric_order_membership/order	1-1
/language/human_language/language_family	1-1
/base/crime/convicted_criminal/convictions./base/crime/criminal_conviction/sentence_type	None
/base/thoroughbredracing/thoroughbred_racehorse_origin/horses_from_this_location	None
/user/robert/us_congress/us_representative/state	1-1
/music/conductor/groups./music/conducting_tenure/ensemble	None
/ice_hockey/hockey_player/current_team./sports/sports_team_roster/team	None
/religion/religious_leader/religious_leadership./religion/religious_organization_leadership/organization	None
/sports/sports_award_type/winners./sports/sports_award/season	1-M
/cvg/computer_videogame/characters./cvg/game_performance/character	1-1
/internet/website_owner/websites_owned_new./internet/website_ownership/website	None
/american_football/football_player/rushing./american_football/player_rushing_statistics/team	None
/film/special_film_performance_type/film_performance_type./film/performance/film	1-M
/sports/sports_position/players./sports/sports_team_roster/team	1-M
/geography/island/island_group	None
/olympics/olympic_sport/athletes./olympics/olympic_athlete_affiliation/athlete	1-M
/sports/pro_athlete/teams./ice_hockey/hockey_roster_position/position	None
/tv/tv_series_episode/writer	None
/film/film_company/films./film/film_film_company_relationship/film	None
/location/hud_foreclosure_area/total_90_day_vacant_residential_addresses./measurement_unit/dated_integer/source	M-1
/venture_capital/venture_funded_company/venture_investors./venture_capital/venture_investment/investor	1-1
/organization/endowed_organization/endowment./measurement_unit/dated_money_value/currency	M-1
/american_football/football_player/former_teams./american_football/football_historical_roster_position/position_s	1-1
/film/film_location/featured_in_films	1-M
/sports/pro_athlete/teams./baseball/baseball_roster_position/position	None
/music/artist/origin	1-1
/tv/tv_program/regular_cast./tv/regular_tv_appearance/actor	1-1
/military/military_commander/military_commands./military/military_command/military_conflict	1-1
/medicine/condition_prevention_factors/conditions_this_may_prevent	None
/tv/tv_program/regular_cast./tv/regular_tv_appearance/special_performance_type	M-1
/base/onephylogeny/type_of_thing/things_of_this_type	None
/user/szaijan/fantasy_football/player/position	None
/broadcast/content/artist	1-M
/comic_books/comic_book_series/publisher	None
/influence/influence_node/influenced	1-M
/government/government_office_or_title/office_holders./government/government_position_held/jurisdiction_of_office	1-1
/base/schemastaging/fish/found_in	None
/base/schemastaging/tv_program_extra/regular_dubbing_performances./base/schemastaging/tv_star_dubbing_performance/actor	1-1
/base/localfood/produce/availability./base/localfood/produce_availability/seasonal_months	1-M
/food/ingredient/cuisine	1-1
/film/film/starring./film/performance/character	1-1
/education/educational_institution/campuses	1-1
/government/government_office_or_title/office_holders./government/government_position_held/legislative_sessions	1-M
/basketball/basketball_position/player_roster_position./basketball/basketball_roster_position/player	1-1
/cvg/cvg_designer/games_designed	None
/organization/organization/organization_type	M-1
/base/nobelprizes/nobel_subject_area/nobel_awards./base/nobelprizes/nobel_honor/nobel_prize_winner	1-1
/base/popstra/religion/membership./base/popstra/religion_choice/member	1-M
/award/competition/instance_of_recurring_competition	None
/award/hall_of_fame_inductee/hall_of_fame_inductions./award/hall_of_fame_induction/category	1-1
/visual_art/artwork/art_form	None
/people/person/profession	M-1
/base/schemastaging/person_extra/net_worth./measurement_unit/dated_money_value/source	M-1
/aviation/airline/airports_served./aviation/airline_airport_presence/cities_served	1-1
/location/statistical_region/gdp_nominal./measurement_unit/dated_money_value/currency	M-1
/music/record_label/artist	1-M
/film/film_casting_director/films_casting_directed	1-M
/music/album_release_type/albums	None
/people/family/members	1-1
/base/petbreeds/dog_breed_group/dog_breeds	None
/baseball/baseball_player/lifetime_batting_statistics./baseball/lifetime_batting_statistics/last_statistics_season	None
/base/newsevents/news_reported_event/news_report_s./base/newsevents/news_report/news_reporting_organisation	None
/geography/river/cities	1-1
/award/award_category/nominees./award/award_nomination/award_nominee	1-M
/base/events/performer/performances./base/events/performance/performer	1-1
/american_football/football_coach/coaching_history./american_football/football_historical_coach_position/position	None
/baseball/baseball_player/current_team./sports/sports_team_roster/position	None
/user/coco/science/concepts_theories/child_concept	1-M
/ice_hockey/hockey_team/historical_roster./sports/sports_team_roster/player	1-1
/business/business_operation/operating_income./measurement_unit/dated_money_value/currency	M-1
/computer/software/developer	1-1
/base/localfood/seasonal_month/produce_available./base/localfood/produce_availability/produce	1-1
/film/film/language	M-1
/venture_capital/venture_investor/investments./venture_capital/venture_investment/company	1-1
/transportation/road/end1./transportation/road_starting_point/location	None
/broadcast/artist/content	M-1
/cvg/computer_videogame/prequel	1-1
/olympics/olympic_sport/athletes./olympics/olympic_athlete_affiliation/olympics	M-M
/organization/organization/sectors	1-1
/base/popstra/celebrity/lived_with./base/popstra/lived_with/participant	1-1
/organization/role/governors./organization/organization_board_membership/member	None
/influence/influence_node/influenced_by	1-1
/medicine/drug/legal_status	1-1
/internet/website/category	1-1
/government/government_office_or_title/office_holders./government/government_position_held/governmental_body	None
/military/armed_force/personnel./military/military_service/rank	1-1
/location/location/street_address./location/mailing_address/state_province_region	None
/astronomy/star_system_body/star_system	None
/business/industry/companies	1-M
/film/producer/films_executive_produced	1-1
/fictional_universe/ethnicity_in_fiction/characters_of_this_ethnicity	None
/medicine/icd_9_cm_classification/parent_classification	None
/people/appointed_role/appointment./people/appointment/appointed_by	1-M
/computer/software/languages_used	None
/sports/sports_league/sport	None
/education/educational_degree/people_with_this_degree./education/education/specialization	1-1
/common/resource/annotations./common/webpage/category	None
/broadcast/content/location	None
/people/person/places_lived./people/place_lived/location	M-1
/user/mt/default_domain/metabolite/biofluid_location	M-1
/religion/religion/practices	None
/user/coco/science/concepts_theories/parent_concept	1-1
/tv/tv_character/appeared_in_tv_program./tv/regular_tv_appearance/special_performance_type	None
/american_football/football_coach/coaching_history./american_football/football_historical_coach_position/team	None
/business/sponsored_recipient/sponsorship./business/sponsorship/sponsored_by	None
/people/cause_of_death/people	1-M
/music/instrument/variation	1-1
/tv/tv_actor/guest_roles./tv/tv_guest_role/episodes_appeared_in	1-1
/base/folklore/mythical_creature/mythology	None
/common/topic/webpage./common/webpage/resource	None
/comic_books/comic_book_character/regular_featured_appearances	1-1
/sports/sports_team/roster./sports/sports_team_roster/player	M-1
/people/ethnicity/languages_spoken	1-1
/film/person_or_entity_appearing_in_film/films./film/personal_film_appearance/type_of_appearance	M-1
/location/location/time_zones	M-1
/sports/pro_athlete/teams./baseball/baseball_roster_position/team	None
/business/brand/owner_s./business/company_brand_relationship/company	1-1
/sports/professional_sports_team/draft_picks./sports/sports_league_draft_pick/draft	M-1
/soccer/football_league/teams./soccer/football_league_participation/team	1-M
/travel/travel_destination/how_to_get_here./travel/transportation/mode_of_transportation	M-1
/comic_books/comic_book_creator/series_created	None
/base/popstra/location/vacationers./base/popstra/vacation_choice/vacationer	1-1
/tv/tv_program_guest/appeared_on./tv/tv_guest_personal_appearance/episode	None
/american_football/football_team/current_roster./american_football/football_roster_position/player	None
/protected_sites/protected_site/iucn_category	None
/base/petbreeds/dog_breed/color	None
/common/topic/subjects	None
/soccer/football_player/current_team./soccer/football_roster_position/position	M-1
/organization/organization/child./organization/organization_relationship/child	1-1
/government/politician/government_positions_held./government/government_position_held/legislative_sessions	1-M
/astronomy/star_system/planetary_system	None
/ice_hockey/hockey_player/current_team./ice_hockey/hockey_roster_position/position	None
/user/robert/military/military_person/participated_in_conflicts	None
/base/wrestling/professional_wrestler/member_of_team	None
/sports/sports_award_type/winners./sports/sports_award/award_winner	1-1
/sports/sports_position/players./baseball/baseball_roster_position/team	1-M
/olympics/olympic_participating_country/olympics_participated_in	M-1
/baseball/baseball_team/historical_roster./baseball/baseball_historical_roster_position/player	1-1
/computer/programming_language/influenced	1-1
/tv/tv_network/programs./tv/tv_network_duration/program	1-M
/user/robert/us_congress/congressional_caucus/current_house_members	1-1
/tv/tv_subject/tv_programs	None
/base/events/festival_series/type_of_festival	1-1
/common/annotation_category/annotations	1-M
/government/politician/government_positions_held./government/government_position_held/district_represented	1-1
/geography/lake/basin_countries	None
/government/government_office_or_title/office_holders./government/government_position_held/appointed_by	1-M
/american_football/football_team/historical_roster./sports/sports_team_roster/player	1-1
/military/military_combatant/force_deployments./military/force_strength/military_conflict	M-1
/biology/breed_origin/breeds_originating_here	1-1
/base/ecology/ecosystem/ecosystem_members	None
/award/award_nominee/award_nominations./award/award_nomination/award	M-1
/base/marchmadness/ncaa_basketball_tournament/seeds./base/marchmadness/ncaa_tournament_seed/team	M-M
/music/artist/contribution./music/recording_contribution/performance_role	1-1
/base/infrastructure/power_plant_type/power_station	None
/base/fight/crime_type/included_in_crimes	None
/film/writer/film	1-1
/cvg/game_voice_actor/computer_game_voice_performances./cvg/game_performance/game	1-1
/book/author/series_written_or_contributed_to	None
/computer/software_genre/software_in_genre	1-1
/user/tsegaran/random/taxonomy_subject/entry./user/tsegaran/random/taxonomy_entry/taxonomy	M-1
/religion/religious_organization/associated_with	1-1
/fictional_universe/fictional_character/romantically_involved_with./fictional_universe/romantic_involvement/partner	None
/biology/animal_breed/place_of_origin	None
/food/dietary_restriction/compatible_ingredients	1-1
/base/contractbridge/bridge_tournament/standing./base/contractbridge/bridge_tournament_standings/second_place	1-M
/base/aareas/schema/administrative_area/capital	1-1
/base/onephylogeny/type_of_thing/included_in	None
/sports/sports_team/roster./american_football/football_roster_position/player	None
/people/ethnicity/geographic_distribution	1-M
/award/award_presenting_organization/award_categories_presented	1-M
/government/political_appointer/appointees./government/government_position_held/office_position_or_title	M-1
/film/actor/dubbing_performances./film/dubbing_performance/character	1-1
/computer/programming_language/dialects	None
/architecture/structure/address./location/mailing_address/state_province_region	None
/organization/organization_scope/organizations_with_this_scope	1-1
/tv/tv_program/episodes	1-M
/film/film/genre	M-1
/music/artist/genre	M-1
/computer/programming_language_paradigm/languages	1-1
/organization/organization/phone_number./common/phone_number/service_location	M-1
/book/periodical/subjects	None
/government/governmental_jurisdiction/agencies	1-1
/royalty/noble_person/titles./royalty/noble_title_tenure/noble_title	None
/finance/currency/countries_used	1-M
/sports/sports_position/players./baseball/baseball_roster_position/player	None
/media_common/literary_genre/books_in_this_genre	None
/sports/sports_team/roster./ice_hockey/hockey_roster_position/player	None
/base/fight/crime_type/people_convicted_of_this_crime./base/crime/criminal_conviction/guilty_of	1-1
/military/military_conflict/combatants./military/military_combatant_group/combatants	1-M
/sports/sports_league_season/awards./sports/sports_award/award_winner	None
/base/activism/activism_issue/activist_organizations	None
/sports/sports_official/sport	None
/government/governmental_jurisdiction/government_positions	None
/computer/programming_language/influenced_by	1-1
/soccer/football_player/current_team./sports/sports_team_roster/position	M-1
/award/hall_of_fame_inductee/hall_of_fame_inductions./award/hall_of_fame_induction/hall_of_fame	M-1
/american_football/football_player/position_s	1-1
/people/person/place_of_birth	M-1
/sports/drafted_athlete/drafted./sports/sports_league_draft_pick/draft	1-1
/location/neighborhood/neighborhood_of	M-1
/royalty/monarch/royal_line	None
/education/educational_institution/mascot	1-1
/language/human_language/dialects	1-1
/medicine/notable_person_with_medical_condition/condition	1-1
/geography/river/mouth	None
/film/film_genre/films_in_this_genre	1-M
/celebrities/celebrity/celebrity_friends./celebrities/friendship/friend	1-1
/fictional_universe/character_occupation/characters_with_this_occupation	1-1
/music/voice/singers	1-M
/broadcast/broadcast/content	None
/film/film/release_date_s./film/film_regional_release_date/film_release_region	M-M
/book/periodical/publisher./book/periodical_publisher_period/publisher	None
/tv/tv_series_season/series	1-1
/government/election/office	None
/base/schemastaging/tv_character_extra/regular_dubbing_performances./base/schemastaging/tv_star_dubbing_performance/program	1-1
/visual_art/artwork/art_subject	1-M
/sports/pro_athlete/teams./ice_hockey/hockey_previous_roster_position/team	1-M
/medicine/drug/drug_class	None
/sports/sports_position/players./basketball/basketball_roster_position/team	1-M
/theater/play/genre	None
/tv/tv_program/regular_cast./tv/regular_tv_appearance/seasons	None
/base/argumentmaps/innovator/original_ideas	None
/government/governmental_jurisdiction/governing_officials./government/government_position_held/district_represented	1-M
/visual_art/visual_art_form/artworks	None
/sports/sports_team/roster./ice_hockey/hockey_previous_roster_position/player	1-1
/base/events/type_of_festival/recurring_festivals_of_this_type	None
/organization/organization_type/organizations_of_this_type	1-1
/celebrities/celebrity/sexual_relationships./celebrities/romantic_relationship/celebrity	1-1
/ice_hockey/hockey_team/historical_roster./ice_hockey/hockey_previous_roster_position/player	1-1
/government/governmental_body/members./government/government_position_held/legislative_sessions	1-M
/base/yalebase/secret_society/notable_members./base/yalebase/secret_society_membership/member	1-M
/education/educational_institution/students_graduates./education/education/minor	1-1
/fictional_universe/fictional_character/place_of_birth	None
/military/armed_force/military_posts./military/military_post_use/military_post	None
/business/business_operation/current_liabilities./measurement_unit/dated_money_value/currency	M-1
/base/crime/crime/victim_s	1-1
/music/artist/album	None
/cvg/game_voice_actor/computer_game_voice_performances./cvg/game_performance/character	None
/government/governmental_jurisdiction/governing_officials./government/government_position_held/governmental_body	None
/base/fight/crime_type/people_convicted_of_this_crime./base/crime/criminal_conviction/convicted_person	1-1
/organization/organization/board_members./organization/organization_board_membership/role	1-1
/award/award_ceremony/awards_presented./award/award_honor/honored_for	1-M
/government/government_agency/jurisdiction	1-1
/sports/sports_team/roster./american_football/football_roster_position/position	M-M
/visual_art/visual_artist/art_forms	1-1
/film/film/written_by	1-1
/olympics/olympic_participating_country/medals_won./olympics/olympic_medal_honor/medalist	1-M
/user/radiusrs/default_domain/astrology/related_topics	1-1
/baseball/baseball_position/players	1-1
/sports/sports_position/players./soccer/football_roster_position/player	1-M
/sports/sports_league_season/awards./sports/sports_award/award	M-1
/location/hud_foreclosure_area/estimated_number_of_mortgages./measurement_unit/dated_integer/source	M-1
/time/recurring_event/instances	1-M
/military/military_person/service./military/military_service/military_force	M-1
/broadcast/radio_format/stations	1-1
/government/governmental_body/offices_positions	1-1
/user/robert/us_congress/us_representative/congressional_caucus_memberships	1-1
/base/biblioness/bibs_location/state	M-1
/baseball/baseball_team/current_roster./baseball/baseball_roster_position/player	None
/people/person/parents	1-1
/biology/organism_classification/rank	1-1
/book/newspaper_owner/newspapers_owned	None
/education/educational_degree/people_with_this_degree./education/education/minor	1-M
/food/ingredient/dishes	None
/tv/tv_program/tv_producer./tv/tv_producer_term/producer	1-1
/soccer/football_player/current_team./soccer/football_roster_position/team	1-1
/ice_hockey/hockey_team/current_roster./ice_hockey/hockey_roster_position/position	M-1
/people/deceased_person/cause_of_death	M-1
/base/patronage/patron/related_client./base/patronage/patron_client_relationship/client	1-1
/language/human_language/countries_spoken_in	1-M
/base/fight/crime_type/victims_of_this_crime_type	None
/dining/cuisine/restaurant	None
/american_football/football_team/historical_coaching_staff./american_football/football_historical_coach_position/position	M-1
/user/robert/us_congress/congressional_district/state	1-1
/broadcast/content/producer	1-1
/base/schemastaging/tv_program_extra/regular_dubbing_performances./base/schemastaging/tv_star_dubbing_performance/language	1-1
/location/place_with_neighborhoods/neighborhoods	1-1
/music/instrument/family	M-1
/people/person/languages	M-1
/cvg/computer_videogame/cvg_genre	1-1
/award/hall_of_fame/inductees./award/hall_of_fame_induction/inductee	1-M
/book/written_work/subjects	None
/tv/tv_character/appeared_in_tv_program./tv/regular_tv_appearance/series	None
/people/marriage_union_type/unions_of_this_type./people/marriage/spouse	1-M
/american_football/football_player/current_team./sports/sports_team_roster/team	None
/tv/tv_character/appeared_in_tv_episodes./tv/tv_guest_role/actor	1-M
/base/endorsements/endorsing_newspaper/endorsements./base/endorsements/newspaper_endorsement/endorsee	None
/basketball/basketball_player/former_teams./sports/sports_team_roster/team	1-1
/music/genre/subgenre	1-M
/tv/tv_program/filming_locations	1-1
/business/board_member/organization_board_memberships./organization/organization_board_membership/role	None
/user/jg/default_domain/olympic_games/sports	M-M
/organization/organization/spin_offs./organization/organization_spin_off/child_company	None
/olympics/olympic_athlete/country./olympics/olympic_athlete_affiliation/country	1-1
/base/popstra/celebrity/wears./base/popstra/fashion_choice/designer	1-1
/organization/organization/phone_number./common/phone_number/category	M-1
/sports/sports_position/players./american_football/football_historical_roster_position/player	1-1
/sports/school_sports_team/school	1-1
/government/political_appointer/appointees./government/government_position_held/jurisdiction_of_office	M-1
/film/film_story_contributor/film_story_credits	1-1
/tv/tv_genre/programs	1-M
/tv/tv_producer/programs_produced./tv/tv_producer_term/program	1-1
/user/narphorium/people/wealthy_person/net_worth./measurement_unit/dated_money_value/currency	1-1
/base/argumentmaps/abstract_moral_dispute/particular_instances	None
/royalty/royal_line/kingdom_s_ruled	1-1
/user/alexander/philosophy/era/philosophers	1-M
/cvg/game_series/games_in_series	None
/business/business_operation/net_profit./measurement_unit/dated_money_value/currency	M-1
/music/group_member/membership./music/group_membership/role	M-1
/basketball/basketball_team/historical_roster./sports/sports_team_roster/player	1-1
/american_football/football_player/games./american_football/player_game_statistics/team	None
/medicine/symptom/symptom_of	1-M
/people/profession/people_with_this_profession	1-M
/comic_books/comic_book_creator/characters_created	1-1
/architecture/architect/structures_designed	None
/fictional_universe/fictional_character/gender	M-1
/sports/pro_athlete/teams./american_football/football_roster_position/position	None
/award/ranked_item/appears_in_ranked_lists./award/ranking/list	M-1
/government/government_office_category/officeholders./government/government_position_held/district_represented	None
